222222222222222222222222
203000000000000250505052
200000050000000202020202
200222220002000000000002
200200350000005000000002
200200000000000000000002
200200000002000005022002
200000000000000000000002
200000022222200220000002
200223020300000020235202
200000020200502020000002
200000020020320020000002
202002020000000020022002
200500022002222220000002
200000000000000000000002
200220000000200000532002
200000000000000000002002
200000500000000000002002
200000000000200022222002
202020202000050000000002
250505052000000000000002
222222222222222222222222
