11111111111111111111111111
10000000000040000000000001
10000200022202220002000001
10000222002000200222000001
10200002002020200200000201
10200000000000000000000201
10222002002202222202022201
10002002200000000000000001
10002200002222000000220001
10000000002000200000222001
10020020222000000022000001
10020020002000020220000001
10202002002000200000000001
12200002002202000000000001
10002000000000000000000001
10202000222220200022002201
10202220000000200000002001
10200022220200222020002001
10020002000020002002002201
10002002000002002000200201
10022002200222002220200201
10000000000000000020202001
10000000000000000000000001
10220222022202220222022201
10000000000000000000000001
10000000000000000000000001
10900900900900900900900901
11111111111111111111111111
