22222222222222222222222222222222
20000000000000000000020000000002
20000000000000000000020000000002
20000000002000000000000000000002
20000000000000000000002200000002
20000000002002000000000000000002
25050200000000000000000000200002
20000200002000022000000000200002
25050200000000022000000000200002
20000200000000000000000000005052
25050000000000000000000000200002
20000200000000022000000000205052
20000200000000022000020000200002
20000200000000000000000000205052
20000000000000000020020000000002
20000000220000000000000000000002
20000000000000000000020000000002
20000000002000000000000000000002
20000000002000000000000000000002
22222222222222222222222222222222