22222222222222222222222222222222
55000000020000000200000000000002
55000000020000000200000000000002
55000020020202000222222207200002
55000000020002000200000000200002
22200000000002000200200000222002
22200200000002000202222222222002
22222222222222000200000000200002
20000000000000022200000000270702
20000000000000022200000000200002
20000222222222222222222020200222
20000200000020000000002000200222
20077200200020000020002000200002
20077200020000000077002000207072
20000200022222222277002000200002
22202200000000000200002000222002
20000200000000000200002000222002
20000200000000000200002000200002
20000222222222000200002000200002
20007700000000000200000000200002
20007700020000000200220000200002
20000000000000000200220000288882
22222222222222222222222222288882

