25555222222222222222222222222222
25555200000000002000002007002088
20000200007700002000002000002088
20000200007700002000000002000088
20000222002000002000007002007088
20000002002000002020222222222222
20000002002000002000000000000002
20000000002000002000000770000002
20000000002002222222222222222002
22222222222002000000000000200002
20000000000002000000000000200772
20000000000002000222222770200772
20027000000002000000002770200222
20022200000002000000002000200002
20000222222222222200002000200002
20000200000700000222002000200002
20077200000200000222002000222002
20077200000000000200002000200002
20000000000200000000002002200002
20000200000200000200002000000002
20000000000200000700002000000002
22222222222222222222222222222222
