2222222222222222222222222222222222
2505050000000200000020000000505052
2000000000000200000020000000000002
2503332000000000000000000002333052
2003332000000200000020000002333002
2503332000000200000020000002333052
2002222002200000220000022002222002
2000000000000000000000000000000002
2000000000000000000000000000000002
2000000000000000220000000000000002
2000000000022000000002200000000002
2000000000022000000002200000000002
2000000000000000220000000000000002
2220220000000000220000000000220222
2000000000000033223300000000000002
2000000000000033223300000000000002
2002000222200222222220022220002002
2002000222200222222220022220002002
2000000000000033223300000000000002
2000000000000033223300000000000002
2220220000000000220000000000220222
2000000000000000220000000000000002
2000000000022000000002200000000002
2000000000022000000002200000000002
2000000000000000220000000000000002
2000000000000000000000000000000002
2000000000000000000000000000000002
2002222002200000220000022002222002
2503332000000200000020000002333052
2003332000000200000020000002333002
2503332000000000000000000002333052
2000000000000200000020000000000002
2505050000000200000020000000505052
2222222222222222222222222222222222