2222222222222222222222222222222222
2300002300000000000000000032000032
2000000000000022002200000000000002
2000022200000020000200000022200002
2000022200000030000300000022200002
2000003000000020000200000003000002
2000200000000320000230000000020002
2000200000002220000222000000020002
2030200002222223003222222000020302
2000000000000022002200000000000002
2000000030000000000000000300000002
2222200002222300000032222000022222
2000000322220000330000222230000002
2000000000000000000000000000000002
2030022222203022002203022222200302
2000020000000020000200000000200002
2000020000000020000200000000200002
2000000320000320000230000230000002
2000022220000020000200000222200002
2000000020000030000300000200000002
2222300020000020000200000200032222
2222200000000022002200000000022222
2222220000000000000000000000222222
2222222222222222222222222222222222
